"filename", "language", "Solidity", "comment", "blank", "total"
"/Users/harryrpo1/Desktop/nealthy/nstbl-loan-manager/contracts/LoanManager.sol", "Solidity", 193, 159, 37, 389
"/Users/harryrpo1/Desktop/nealthy/nstbl-loan-manager/contracts/LoanManagerStorage.sol", "Solidity", 31, 26, 23, 80
"/Users/harryrpo1/Desktop/nealthy/nstbl-loan-manager/contracts/TokenLP.sol", "Solidity", 30, 13, 14, 57
"/Users/harryrpo1/Desktop/nealthy/nstbl-loan-manager/contracts/interfaces/IERC20Helper.sol", "Solidity", 6, 4, 4, 14
"/Users/harryrpo1/Desktop/nealthy/nstbl-loan-manager/contracts/interfaces/ILoanManager.sol", "Solidity", 12, 10, 13, 35
"/Users/harryrpo1/Desktop/nealthy/nstbl-loan-manager/contracts/interfaces/maple/IPool.sol", "Solidity", 18, 1, 2, 21
"/Users/harryrpo1/Desktop/nealthy/nstbl-loan-manager/contracts/interfaces/maple/IPoolManager.sol", "Solidity", 49, 251, 45, 345
"/Users/harryrpo1/Desktop/nealthy/nstbl-loan-manager/contracts/interfaces/maple/IWithdrawalManager.sol", "Solidity", 33, 111, 23, 167
"/Users/harryrpo1/Desktop/nealthy/nstbl-loan-manager/contracts/interfaces/maple/IWithdrawalManagerStorage.sol", "Solidity", 18, 36, 9, 63
"Total", "-", 390, 611, 170, 1171